


    NO    wall_textures/path.png     

    SO    wall_textures/path.png 


    EA    wall_textures/path.png 


    WE    wall_textures/path.png 

    C     0,0,0



    F     120,120,120


        11111111111 1111111111111
        10000000001 1000000000001
        1011000001111000000000001
        1001000000000000000000001
111111111011000001110000000000001
100000000011000001110111111111111
11110111111111011100000010001
11110111111111011101010010001
11000000110101011100000010001
10000000000000001100000010001
10000000000000001101010010001
11000001110101011111011110N0111
11110111 1110101 101111010001
11111111 1111111 111111111111